XXXXXXXXXXXXXX
X X     X    X
X XXX X X XX X
X  X  XX XXX X
X  X XXX  X  X
X    X  X    X
X X XXX X XXXX
X X  X  X   XX
X XX         X
X    X       X
XXXXXXXXXXXXXX
